#####
#C#X#
#.#.#
#...#
#####